000000000000000000000000
000000000000000000000000
000000000000000000400000
000000000000000000000000
000000001111111000000000
000000001030001000000000
000000001000201000000000
000000001111111000000000
000000000000000000000000
000000000004000000000000
000000000000000000000000
000000000000000000000000
